####################
#.+................#
#..................#
#..................#
#......K....Z......#
#..................#
#...........D......#
#..................#
#.......D..........#
#..........Z.......#
#..+...............#
#..................#
#....D........######
#.............#P...#
#..................#
#....Z.............#
#..........Z.......#
#..................#
#+.................#
###################